P9ZS3-------	MMI0001
P9FS3-------	MMI0001
VmHS------A-	MMI0002
VmXP------A-	MMI0002
ClNP2-------	MMI0003
CdNP4-------	MMI0003
AUMS5F------	MMI0003
CdMS6-------	MMI0003
ClYP5-------	MMI0003
CwFS7-------	MMI0003
PSNP5-S1----	MMI0003
AANP7----2N-	MMI0003
ClHP5-------	MMI0003
AMNP7-----N-	MMI0003
CdNP2-------	MMI0003
PP-P5--1----	MMI0003
CdFS3-------	MMI0003
P8NP5-------	MMI0003
P8IP5-------	MMI0003
AUNS5F------	MMI0003
CyFS5-------	MMI0003
AUMP6M------	MMI0004
AAMP6----2A-	MMI0004
AAMP6----1A-	MMI0004
AAMP6----1N-	MMI0004
AAMP6----3A-	MMI0004
AAFP1----2N-	MMI0005
AAIS1----2N-	MMI0005
CdXP1-------	MMI0006
NNNP1-----N-	MMI0006
PJMP1-------	MMI0006
AUNP5M------	MMI0006
Vt-P---3P-NA	MMI0006
PKM-1--2----	MMI0006
PZNS5-------	MMI0006
VqMP---XR-AA	MMI0006
Vt-S---1P-AA	MMI0006
CzMP1-------	MMI0006
Vt-S---2P-AA	MMI0006
P8NS1-------	MMI0006
AOIP--------	MMI0006
AGMS4-----N-	MMI0007
AAMS4----3N-	MMI0007
AAMS4----2N-	MMI0007
AMMS4-----A-	MMI0008
AGMS4-----A-	MMI0008
NNIS1-----N-	MMI0009
PSNS4-S2----	MMI0009
AUFP2F------	MMI0009
NNND7-----A-	MMI0009
AAFD7----1N-	MMI0009
AMFP6-----N-	MMI0009
NNNS5-----A-	MMI0009
NNIP5-----A-	MMI0009
NNFS5-----N-	MMI0009
CzFS4-------	MMI0009
NNNP5-----A-	MMI0009
PLYS5-------	MMI0009
CwFS3-------	MMI0009
PZFD7-------	MMI0009
NNIS4-----N-	MMI0009
CzMS4-------	MMI0009
AGNS4-----N-	MMI0010
AGFP4-----N-	MMI0010
PDYS4-------	MMI0010
AANP2----2N-	MMI0011
AAIP2----3N-	MMI0011
AAFP2----3N-	MMI0011
AANP2----3N-	MMI0011
AAXXX-----A-	MMI0012
NNXS1-----A-	MMI0012
PPMS1--3----	MMI0012
VsFS---2H-AP	MMI0012
AANSX----1A-	MMI0012
Vt-P---3P-AA	MMI0012
AAFP6----2N-	MMI0012
CzZS3-------	MMI0012
AAIS6----3N-	MMI0012
P4FD7-------	MMI0012
CwZS6-------	MMI0013
PSZS6-S2----	MMI0013
AGIS6-----N-	MMI0013
CdYS6-------	MMI0013
CdFS2-------	MMI0014
AGNS2-----N-	MMI0014
PLMS2-------	MMI0014
AANP5----1A-	MMI0014
PZ--5-------	MMI0015
CdMS4-------	MMI0015
AAFS4----3N-	MMI0016
AGMP4-----N-	MMI0016
PSXXXNS3----	MMI0017
PSXXXYS3----	MMI0017
PSFS7-S2----	MMI0018
AUFS7F------	MMI0018
CdFS7-------	MMI0018
PSXP4-S2----	MMI0019
PSYP4-S2----	MMI0019
PSMP1-P2----	MMI0020
PSMP1-S2----	MMI0020
AANS3----3N-	MMI0021
PSZS3-S2----	MMI0021
AGMS3-----N-	MMI0021
AANS3----2N-	MMI0021
AUMS6M------	MMI0022
AAMS6----1N-	MMI0022
PSXP2-S2----	MMI0023
CdXP2-------	MMI0023
PPXPX--3----	MMI0024
PP-PX--1----	MMI0024
PPMSX--3----	MMI0024
PSXP3-S2----	MMI0025
AUFP3M------	MMI0025
P1XP3FS3----	MMI0025
AUNP3F------	MMI0025
AANS6----3N-	MMI0026
CzZS6-------	MMI0026
AGNS6-----N-	MMI0026
AANS6----2N-	MMI0026
AMNP7-----A-	MMI0027
NNNP7-----N-	MMI0027
PLFD7-------	MMI0027
CdNP7-------	MMI0027
AAIP7----2N-	MMI0027
CdXP7-------	MMI0027
AMNS3-----A-	MMI0028
CwZS3-------	MMI0028
CzNP4-------	MMI0029
CzYS1-------	MMI0029
CzZS2-------	MMI0029
AAFS2----3N-	MMI0030
AAFS2----2N-	MMI0030
AAXPX----1A-	MMI0031
P8NS2-------	MMI0031
PKM-4--2----	MMI0032
Dg-------3N-	MMI0032
PKM-3--2----	MMI0032
AMNS3-----N-	MMI0032
VpYS---2R-NA	MMI0032
PQ--3--2----	MMI0032
Ck-P6-------	MMI0032
PSNP5-S2----	MMI0032
VpNS---2R-AA	MMI0032
CwXP3-------	MMI0032
NNMS1-----N-	MMI0032
AGNP4-----N-	MMI0032
AUMP5F------	MMI0032
Cj-S2-------	MMI0032
PLMP5-------	MMI0033
AGNP1-----N-	MMI0033
AMNS6-----N-	MMI0033
AAIP4----3N-	MMI0033
AMNS2-----A-	MMI0033
ACFS4-----N-	MMI0033
VsFS4--XX-NP	MMI0033
AUMS5M------	MMI0033
PH-S2--2----	MMI0033
CrMS5-------	MMI0033
CdMP1-------	MMI0033
ChNP4-------	MMI0033
CwMP1-------	MMI0033
PSZS7-S2----	MMI0034
AUIS7F------	MMI0034
PPNP1--3----	MMI0035
P8YS5-------	MMI0035
CrNP5-------	MMI0035
PSFP4-S1----	MMI0036
P1XP4FS3----	MMI0036
PSFD7-P1----	MMI0037
CdFD7-------	MMI0037
AGNP7-----N-	MMI0037
PSFD7-S1----	MMI0037
PSFD7-S2----	MMI0037
PSFD7FS3----	MMI0037
ChFD7-------	MMI0037
CwXP6-------	MMI0038
CdNP6-------	MMI0038
CrMP6-------	MMI0038
CdXP3-------	MMI0038
NNNP6-----N-	MMI0038
PQ--6--2----	MMI0038
AANS5----3N-	MMI0038
AMNS6-----A-	MMI0038
AANS7----2N-	MMI0039
AANS7----3N-	MMI0039
CwNP4-------	MMI0040
CwNP1-------	MMI0040
PZNP5-------	MMI0040
VpFS---2R-NA	MMI0041
PDMS7-------	MMI0041
CzZS7-------	MMI0041
VsNS---2H-AP	MMI0041
PLNS5-------	MMI0041
VqTP---XR-AA	MMI0041
Vt-S---3F-AA	MMI0041
Vt-S---3P-NA	MMI0041
VqYS---XR-NA	MMI0041
Vi-P---3--N-	MMI0041
VqQW---XR-NA	MMI0041
VqNS---XR-AA	MMI0041
CwNS1-------	MMI0041
VqYS---XR-AA	MMI0041
VmHS------N-	MMI0041
PLNS2-------	MMI0041
VqMP---XR-NA	MMI0041
Vi-S---3--N-	MMI0041
Vt-P---3F-AA	MMI0041
Vt-S---3P-AA	MMI0041
P4YS2-------	MMI0041
VmXP------N-	MMI0042
AMFS6-----N-	MMI0042
VmYS------N-	MMI0042
NNNP3-----N-	MMI0042
AMNP6-----N-	MMI0042
AGFP3-----N-	MMI0043
AGMP3-----N-	MMI0043
AAMS5----1N-	MMI0044
AAMP5----1N-	MMI0044
PSYS5-P2----	MMI0044
PSMP5-P1----	MMI0044
PSMP5-P2----	MMI0044
PSIP5-S2----	MMI0044
PSHS5-P1----	MMI0044
PSYS5-S2----	MMI0044
CzFP1-------	MMI0045
PJXP1-------	MMI0045
AAMS6----2A-	MMI0045
CzIS4-------	MMI0045
ClXSX-------	MMI0045
AUIS3F------	MMI0045
Vt-S---3F-NA	MMI0045
Ck-P7-------	MMI0045
P8FS1-------	MMI0045
Vt-P---1P-AA	MMI0045
CzXP3-------	MMI0045
AMFS4-----A-	MMI0045
Ck-P1-------	MMI0045
Ck-P2-------	MMI0045
NNNXX-----N-	MMI0045
CzFS1-------	MMI0045
AAIS4----3N-	MMI0046
CdIS4-------	MMI0046
AAIS4----2N-	MMI0046
AUNS6M------	MMI0047
CdNS6-------	MMI0047
AGMP6-----A-	MMI0048
AUNP1F------	MMI0048
AANP7----2A-	MMI0049
AGFD7-----A-	MMI0049
CrFD7-------	MMI0050
AAFD7----3A-	MMI0050
AAFP3----3N-	MMI0050
CrFS5-------	MMI0050
AOFP--------	MMI0050
AUMP3M------	MMI0050
AUIS5F------	MMI0050
CrFP5-------	MMI0050
AUFP3F------	MMI0050
AAIS3----2N-	MMI0050
AAFD7----2A-	MMI0050
AMFP7-----A-	MMI0050
AMMS1-----A-	MMI0051
PSMP5-S2----	MMI0051
AAFS1----2N-	MMI0051
PZM-5-------	MMI0051
PSFS3-S2----	MMI0052
PSFS3-S1----	MMI0052
PSXP7-S2----	MMI0053
AUIP7F------	MMI0053
AANP7----3N-	MMI0053
ChIP1-------	MMI0054
ChFP1-------	MMI0054
PSXP6-S2----	MMI0055
CdXP6-------	MMI0055
PSXP6-P2----	MMI0055
PSIP1-S2----	MMI0056
AAMP1----3N-	MMI0056
AMMP1-----A-	MMI0056
AMNS1-----N-	MMI0056
CzYP4-------	MMI0057
CzFS7-------	MMI0057
AMMS4-----N-	MMI0058
AMNP2-----N-	MMI0058
AMFS2-----N-	MMI0058
CwFS2-------	MMI0058
AMNS4-----N-	MMI0058
AMFS7-----N-	MMI0058
CwXP7-------	MMI0058
AMFS7-----A-	MMI0058
AMNS7-----N-	MMI0058
AANS5----2N-	MMI0058
VsFS---2H-NP	MMI0058
AMNS2-----N-	MMI0058
Vt-S---1F-NA	MMI0058
AANP3----2N-	MMI0059
AANP3----3N-	MMI0059
AAIS2----3N-	MMI0060
AANS2----2N-	MMI0060
AAFS6----2N-	MMI0061
AAFS6----3N-	MMI0061
AGFS6-----N-	MMI0061
VsNS---2H-NP	MMI0062
ClNS5-------	MMI0062
PQ--2--2----	MMI0062
CwXP2-------	MMI0062
Cn-XX-------	MMI0062
ClXP5-------	MMI0062
PZYS5-------	MMI0062
P1XP6FS3----	MMI0063
PSXP6-S1----	MMI0063
AUNP6F------	MMI0063
PQ--4--2----	MMI0064
PJIS4-------	MMI0064
PQ--7--2----	MMI0064
J,-S---2----	MMI0064
AUNP6M------	MMI0065
AANP6----1N-	MMI0065
CrMS6-------	MMI0066
AAMS6----3A-	MMI0066
AUFS6M------	MMI0067
PSFS6-S2----	MMI0067
AANS5----1N-	MMI0068
PSZS5FS3----	MMI0068
AANS5----2A-	MMI0068
AANS5----1A-	MMI0068
AANS5----3A-	MMI0068
AAMP1----2N-	MMI0069
AAFP2----2N-	MMI0069
CdFP2-------	MMI0069
AAFP7----3N-	MMI0069
AMIS3-----A-	MMI0069
AUIS6F------	MMI0069
AAIS7----2N-	MMI0069
AOFS--------	MMI0069
AAIS2----2N-	MMI0069
AUFD7M------	MMI0069
AAIS7----3N-	MMI0069
AMFP4-----N-	MMI0069
P8MP1-------	MMI0070
P8MP5-------	MMI0070
AANS4----3N-	MMI0071
AAFP4----3N-	MMI0071
AAMP6----3N-	MMI0072
AANP6----2N-	MMI0072
AANP6----3N-	MMI0072
PSMS4-P2----	MMI0073
PSMS4-S2----	MMI0073
AAFS3----3N-	MMI0074
AAFS3----2N-	MMI0074
ChNP1-------	MMI0075
PDFS1-------	MMI0075
AANP5----1N-	MMI0076
AAFS5----1A-	MMI0076
CwFS1-------	MMI0077
CdNP1-------	MMI0077
AAIS6----2N-	MMI0078
PDZS6-------	MMI0078
CzXP6-------	MMI0079
AAFP6----1A-	MMI0079
PDFS6-------	MMI0080
CdFS6-------	MMI0080
