CwXP6-------	MMI0001
CdNP6-------	MMI0001
AANS5----3N-	MMI0001
VqYS---XR-NA	MMI0002
VqTP---XR-AA	MMI0002
Vi-S---3--N-	MMI0002
VqQW---XR-NA	MMI0002
VqMP---XR-NA	MMI0002
Vt-P---3F-AA	MMI0002
Cn-XX-------	MMI0003
VsNS---2H-NP	MMI0003
CwXP2-------	MMI0003
ClNS5-------	MMI0003
AANSX----1A-	MMI0004
Vt-P---3P-AA	MMI0004
PSYS5-S2----	MMI0005
PSIP5-S2----	MMI0005
AAMS5----1N-	MMI0005
NNFS5-----N-	MMI0006
PZFD7-------	MMI0006
PSNS4-S2----	MMI0006
AAFD7----1N-	MMI0006
CzFS4-------	MMI0006
NNND7-----A-	MMI0006
CzMS4-------	MMI0006
PLNS2-------	MMI0007
PLNS5-------	MMI0007
P4YS2-------	MMI0007
AGNP4-----N-	MMI0008
AMNS3-----N-	MMI0008
CwXP3-------	MMI0008
AUNP5M------	MMI0009
PZNS5-------	MMI0009
NNNP1-----N-	MMI0009
Vt-S---2P-AA	MMI0009
Vt-P---3P-NA	MMI0009
AMFP6-----N-	MMI0010
NNIS4-----N-	MMI0010
NNIS1-----N-	MMI0010
CwFS3-------	MMI0010
AANS5----2A-	MMI0011
PSZS5FS3----	MMI0011
CwNS1-------	MMI0012
Vt-S---3F-AA	MMI0012
AAMP6----2A-	MMI0013
AAMP6----3A-	MMI0013
Cj-S2-------	MMI0014
PKM-3--2----	MMI0014
CdMP1-------	MMI0015
AMNS6-----N-	MMI0015
CwMP1-------	MMI0015
NNXS1-----A-	MMI0016
CzZS3-------	MMI0016
AAIS6----3N-	MMI0016
AAFP6----2N-	MMI0016
Ck-P7-------	MMI0017
AMFS4-----A-	MMI0017
CzFP1-------	MMI0017
CyFS5-------	MMI0018
AANP7----2N-	MMI0018
CdNP2-------	MMI0018
AUIS3F------	MMI0019
CzFS1-------	MMI0019
Vt-S---3F-NA	MMI0019
CzXP3-------	MMI0019
Ck-P2-------	MMI0019
CzIS4-------	MMI0019
Vt-P---1P-AA	MMI0019
CdFD7-------	MMI0020
AGNP7-----N-	MMI0020
AAFD7----2A-	MMI0021
CrFD7-------	MMI0021
AMFP7-----A-	MMI0021
AAFD7----3A-	MMI0021
CdFS3-------	MMI0022
CdMS6-------	MMI0022
CdNP4-------	MMI0022
AMFP4-----N-	MMI0023
CdFP2-------	MMI0023
AMIS3-----A-	MMI0023
AUIS6F------	MMI0023
PJIS4-------	MMI0024
PQ--7--2----	MMI0024
AANP5----1N-	MMI0025
AAFS5----1A-	MMI0025
CrFS5-------	MMI0026
AUIS5F------	MMI0026
AAFP3----3N-	MMI0027
AUFP3F------	MMI0027
AAIS3----2N-	MMI0027
CwFS2-------	MMI0028
AMNS7-----N-	MMI0028
VsFS---2H-NP	MMI0028
AANS5----2N-	MMI0029
AMNS4-----N-	MMI0029
CwXP7-------	MMI0029
NNNXX-----N-	MMI0030
PJXP1-------	MMI0030
AUMS5M------	MMI0031
CrMS5-------	MMI0031
PKM-4--2----	MMI0032
NNMS1-----N-	MMI0032
AMFS7-----N-	MMI0033
Vt-S---1F-NA	MMI0033
PQ--6--2----	MMI0034
CdXP3-------	MMI0034
AAFP7----3N-	MMI0035
AAIS2----2N-	MMI0035
AAMP1----2N-	MMI0035
AUFD7M------	MMI0035
CwFS1-------	MMI0036
CdNP1-------	MMI0036
AAXXX-----A-	MMI0037
P4FD7-------	MMI0037
PDZS6-------	MMI0038
AAIS6----2N-	MMI0038
CzXP6-------	MMI0039
AAFP6----1A-	MMI0039
AUFP2F------	MMI0040
PLYS5-------	MMI0040
CdFS6-------	MMI0041
PDFS6-------	MMI0041
