AAIS4----3N-	MMI0001
AAIS4----2N-	MMI0001
AAMP6----3N-	MMI0002
AANP6----2N-	MMI0002
AANP6----3N-	MMI0002
AAXXX-----A-	MMI0003
AAFP6----2N-	MMI0003
P4FD7-------	MMI0003
CzZS3-------	MMI0003
AANSX----1A-	MMI0003
Vt-P---3P-AA	MMI0003
VsFS---2H-AP	MMI0003
AAIS6----3N-	MMI0003
NNXS1-----A-	MMI0003
AUFP3F------	MMI0004
AMFP7-----A-	MMI0004
AUMP3M------	MMI0004
AAFP3----3N-	MMI0004
AAFD7----3A-	MMI0004
AAIS3----2N-	MMI0004
AAFD7----2A-	MMI0004
CrFD7-------	MMI0004
AANS6----3N-	MMI0005
AANS6----2N-	MMI0005
CzZS6-------	MMI0005
CwZS6-------	MMI0006
AGIS6-----N-	MMI0006
AMMS4-----N-	MMI0007
VsFS---2H-NP	MMI0007
AMNS2-----N-	MMI0007
AMNS4-----N-	MMI0007
AANS5----2N-	MMI0007
AMNS7-----N-	MMI0007
Vt-S---1F-NA	MMI0007
CwFS2-------	MMI0007
AMNP2-----N-	MMI0007
AMFS7-----N-	MMI0007
AMFS2-----N-	MMI0007
CwXP7-------	MMI0007
PSMS4-S2----	MMI0008
PSMS4-P2----	MMI0008
PPNP1--3----	MMI0009
P8YS5-------	MMI0009
P1XP3FS3----	MMI0010
PSXP3-S2----	MMI0010
CdXP7-------	MMI0011
CdNP7-------	MMI0011
NNNP7-----N-	MMI0011
PLFD7-------	MMI0011
Vt-S---3P-AA	MMI0012
VsNS---2H-AP	MMI0012
AANP7----3N-	MMI0013
PSXP7-S2----	MMI0013
PLNS5-------	MMI0014
VqNS---XR-AA	MMI0014
PLNS2-------	MMI0014
VqTP---XR-AA	MMI0014
Vi-S---3--N-	MMI0014
Vt-P---3F-AA	MMI0014
VmHS------N-	MMI0014
Vi-P---3--N-	MMI0014
P4YS2-------	MMI0014
VqMP---XR-NA	MMI0014
VqQW---XR-NA	MMI0014
Vt-S---3P-NA	MMI0014
VqYS---XR-NA	MMI0014
VqYS---XR-AA	MMI0014
AAMP6----3A-	MMI0015
AAMP6----1N-	MMI0015
AAMP6----2A-	MMI0015
AUMP6M------	MMI0015
Ck-P6-------	MMI0016
AUMP5F------	MMI0016
PSNP5-S2----	MMI0016
Vt-P---3P-NA	MMI0017
AUNP5M------	MMI0017
Vt-S---2P-AA	MMI0017
VqMP---XR-AA	MMI0017
Vt-S---1P-AA	MMI0017
CzMP1-------	MMI0017
NNNP1-----N-	MMI0017
PZNS5-------	MMI0017
P8IP5-------	MMI0018
CdNP4-------	MMI0018
CyFS5-------	MMI0018
CdFS3-------	MMI0018
P8NP5-------	MMI0018
AANP7----2N-	MMI0018
CdNP2-------	MMI0018
CdMS6-------	MMI0018
PSXP6-S2----	MMI0019
CdXP6-------	MMI0019
PKM-4--2----	MMI0020
VpNS---2R-AA	MMI0020
NNMS1-----N-	MMI0020
PQ--3--2----	MMI0020
CdMP1-------	MMI0021
AGNP1-----N-	MMI0021
AUMS5M------	MMI0021
CrMS5-------	MMI0021
ACFS4-----N-	MMI0021
AMNS6-----N-	MMI0021
CwMP1-------	MMI0021
CzIS4-------	MMI0022
Ck-P2-------	MMI0022
CzXP3-------	MMI0022
Vt-P---1P-AA	MMI0022
Ck-P7-------	MMI0022
NNNXX-----N-	MMI0022
AUIS3F------	MMI0022
CzFP1-------	MMI0022
AAMS6----2A-	MMI0022
P8FS1-------	MMI0022
Vt-S---3F-NA	MMI0022
CzFS1-------	MMI0022
PJXP1-------	MMI0022
Ck-P1-------	MMI0022
AMFS4-----A-	MMI0022
CdFD7-------	MMI0023
ChFD7-------	MMI0023
AGNP7-----N-	MMI0023
PSFD7FS3----	MMI0023
PSFD7-S2----	MMI0023
AUNP6F------	MMI0024
P1XP6FS3----	MMI0024
AMMP1-----A-	MMI0025
AMNS1-----N-	MMI0025
PSIP1-S2----	MMI0025
AMNS2-----A-	MMI0026
AAIP4----3N-	MMI0026
PH-S2--2----	MMI0026
AOFP--------	MMI0027
AUIS5F------	MMI0027
CrFP5-------	MMI0027
CrFS5-------	MMI0027
PSMP5-P2----	MMI0028
PSMP5-P1----	MMI0028
AAMP5----1N-	MMI0028
VpFS---2R-NA	MMI0029
CwNS1-------	MMI0029
Vt-S---3F-AA	MMI0029
PDMS7-------	MMI0029
CzZS7-------	MMI0029
ClXP5-------	MMI0030
ClNS5-------	MMI0030
Cn-XX-------	MMI0030
CwXP2-------	MMI0030
PQ--2--2----	MMI0030
VsNS---2H-NP	MMI0030
AAFS3----2N-	MMI0031
AAFS3----3N-	MMI0031
ChNP4-------	MMI0032
VsFS4--XX-NP	MMI0032
PSMP5-S2----	MMI0033
PZM-5-------	MMI0033
AAFD7----1N-	MMI0034
AMFP6-----N-	MMI0034
CzMS4-------	MMI0034
NNIS4-----N-	MMI0034
AUFP2F------	MMI0034
NNIS1-----N-	MMI0034
CzFS4-------	MMI0034
PSNS4-S2----	MMI0034
NNND7-----A-	MMI0034
NNFS5-----N-	MMI0034
PLYS5-------	MMI0034
PZFD7-------	MMI0034
CwFS3-------	MMI0034
AAFS6----3N-	MMI0035
AAFS6----2N-	MMI0035
ChNP1-------	MMI0036
PDFS1-------	MMI0036
CwXP3-------	MMI0037
VpYS---2R-NA	MMI0037
PKM-3--2----	MMI0037
AMNS3-----N-	MMI0037
AGNP4-----N-	MMI0037
Cj-S2-------	MMI0037
AANS3----3N-	MMI0038
AANS3----2N-	MMI0038
CwXP6-------	MMI0039
PQ--6--2----	MMI0039
CdNP6-------	MMI0039
NNNP6-----N-	MMI0039
CdXP3-------	MMI0039
AANS5----3N-	MMI0039
AMFS6-----N-	MMI0040
VmXP------N-	MMI0040
AMNP6-----N-	MMI0040
PKM-1--2----	MMI0041
P8NS1-------	MMI0041
AMFP4-----N-	MMI0042
AAFP7----3N-	MMI0042
AUIS6F------	MMI0042
AAIS7----2N-	MMI0042
CdFP2-------	MMI0042
AMIS3-----A-	MMI0042
AAMP1----2N-	MMI0042
AAFP2----2N-	MMI0042
AAIS2----2N-	MMI0042
AUFD7M------	MMI0042
AAIS7----3N-	MMI0042
CwNP1-------	MMI0043
CwNP4-------	MMI0043
PSNP5-S1----	MMI0044
ClYP5-------	MMI0044
ClHP5-------	MMI0044
CwFS7-------	MMI0045
AMNP7-----N-	MMI0045
PP-P5--1----	MMI0045
PSZS5FS3----	MMI0046
AANS5----2A-	MMI0046
AANS5----1N-	MMI0046
AANS5----3A-	MMI0046
PSYS5-P2----	MMI0047
PSIP5-S2----	MMI0047
AAMS5----1N-	MMI0047
PSYS5-S2----	MMI0047
NNIP5-----A-	MMI0048
NNNP5-----A-	MMI0048
CdFS7-------	MMI0049
PSFS7-S2----	MMI0049
PQ--7--2----	MMI0050
PQ--4--2----	MMI0050
PJIS4-------	MMI0050
AUNS5F------	MMI0051
AUMS5F------	MMI0051
AAFS5----1A-	MMI0052
AANP5----1N-	MMI0052
CwFS1-------	MMI0053
CdNP1-------	MMI0053
PDZS6-------	MMI0054
AAIS6----2N-	MMI0054
CzXP6-------	MMI0055
AAFP6----1A-	MMI0055
PDFS6-------	MMI0056
CdFS6-------	MMI0056
